{
    "tiles" : [ [1, 2, 2, 4, 3, 2, 2, 1],
                [2, 4, 4, 1, 4, 4, 2, 2],
                [2, 4, 1, 4, 1, 2, 1, 3],
                [3, 1, 2, 1, 2, 2, 1, 1],
                [1, 2, 3, 1, 3, 1, 2, 2],
                [2, 2, 3, 2, 2, 1, 3, 3],
                [4, 3, 2, 4, 3, 4, 2, 1]],
    "bufferTiles" : {
        "tiles":[[1, 2, 2, 4, 3, 2, 2, 2, 1],
                [2, 4, 4, 1, 4, 4, 2, 2, 1],
                [2, 4, 1, 4, 1, 2, 1, 2, 3],
                [3, 1, 2, 1, 2, 2, 1, 2, 1],
                [1, 2, 3, 1, 3, 1, 2, 2, 3],
                [2, 2, 3, 2, 2, 1, 3, 2, 1],
                [4, 3, 2, 4, 3, 4, 2, 2, 3],
                [1, 2, 3, 2, 1, 2, 2, 2, 1],
                [4, 2, 3, 1, 2, 3, 1, 1, 2],
                [1, 2, 2, 4, 3, 2, 2, 2, 1],
                [2, 4, 4, 1, 4, 4, 2, 2, 4],
                [2, 4, 1, 4, 1, 2, 1, 2, 1],
                [3, 1, 2, 1, 2, 2, 1, 2, 1],
                [1, 2, 3, 1, 3, 1, 2, 2, 3],
                [2, 2, 3, 2, 2, 1, 3, 2, 1],
                [4, 3, 2, 4, 3, 4, 2, 2, 1],
                [1, 2, 3, 2, 1, 2, 2, 2, 2],
                [4, 2, 3, 1, 2, 3, 1, 1, 2]],
        "offset":[17, 17, 17, 17, 17, 17, 17, 17, 17]
    },
    "targetScore" : 100,
    "moves" : 15
}